8 8 
4 8 37 3 4 8 7 3 
2 5 29 3 2 5 9 3 
6 3 22 18 17 3 2 5 
4 4 1 15 16 3 2 5 
4 8 7 13 4 8 7 3 
2 5 9 10 2 5 9 3 
6 3 2 8 6 3 2 5 
4 0 9 1 6 3 2 5 